000000000-
222222220-
000000020-
000000020-
022222220-
020000000-
020000000-
022222220-
000000020-
000000020-
022222220-
020000000-
020000000-
022222220
