000000000000000000000000-
000000000000000000000000-
020002222222200222222020-
020002000000200200002020-
020002000000200200002220-
020002000222200222200000-
020002000200000000200000-
020002000200222200200000-
020002000200200200200000-
020002000200200200200000-
020002000200200200200000-
022222000222200222200000-
000000000000000000000000-
000000000000000000000000